alias agentactivationruntimestarter=agentactivationruntimestarter.exe
alias AggregatorHost=AggregatorHost.exe
alias aitstatic=aitstatic.exe
alias alg=alg.exe
alias amdfendrsr=amdfendrsr.exe
alias amdlogum=amdlogum.exe
alias AppHostRegistrationVerifier=AppHostRegistrationVerifier.exe
alias appidcertstorecheck=appidcertstorecheck.exe
alias appidpolicyconverter=appidpolicyconverter.exe
alias appidtel=appidtel.exe
alias AppInstallerBackgroundUpdate=AppInstallerBackgroundUpdate.exe
alias ApplicationFrameHost=ApplicationFrameHost.exe
alias ApplyTrustOffline=ApplyTrustOffline.exe
alias ApproveChildRequest=ApproveChildRequest.exe
alias at=at.exe
alias AtBroker=AtBroker.exe
alias atieah64=atieah64.exe
alias atieclxx=atieclxx.exe
alias attrib=attrib.exe
alias audiodg=audiodg.exe
alias auditpol=auditpol.exe
alias AuthHost=AuthHost.exe
alias autochk=autochk.exe
alias AutoModeDetect=AutoModeDetect.exe
alias AxInstUI=AxInstUI.exe
alias backgroundTaskHost=backgroundTaskHost.exe
alias BackgroundTransferHost=BackgroundTransferHost.exe
alias bcdboot=bcdboot.exe
alias bcdedit=bcdedit.exe
alias BdeUISrv=BdeUISrv.exe
alias bdeunlock=bdeunlock.exe
alias BioIso=BioIso.exe
alias BitLockerDeviceEncryption=BitLockerDeviceEncryption.exe
alias BitLockerWizardElev=BitLockerWizardElev.exe
alias bitsadmin=bitsadmin.exe
alias bootim=bootim.exe
alias bootsect=bootsect.exe
alias bridgeunattend=bridgeunattend.exe
alias browserexport=browserexport.exe
alias browser_broker=browser_broker.exe
alias bthudtask=bthudtask.exe
alias ByteCodeGenerator=ByteCodeGenerator.exe
alias cacls=cacls.exe
alias calc=calc.exe
alias CameraSettingsUIHost=CameraSettingsUIHost.exe
alias CastSrv=CastSrv.exe
alias CertEnrollCtrl=CertEnrollCtrl.exe
alias certreq=certreq.exe
alias certutil=certutil.exe
alias changepk=changepk.exe
alias charmap=charmap.exe
alias CheckNetIsolation=CheckNetIsolation.exe
alias chkdsk=chkdsk.exe
alias chkntfs=chkntfs.exe
alias choice=choice.exe
alias CIDiag=CIDiag.exe
alias cipher=cipher.exe
alias CiTool=CiTool.exe
alias cleanmgr=cleanmgr.exe
alias cliconfg=cliconfg.exe
alias clinfo=clinfo.exe
alias clip=clip.exe
alias ClipRenew=ClipRenew.exe
alias ClipUp=ClipUp.exe
alias CloudExperienceHostBroker=CloudExperienceHostBroker.exe
alias CloudNotifications=CloudNotifications.exe
alias cmd=cmd.exe
alias cmdkey=cmdkey.exe
alias cmdl32=cmdl32.exe
alias cmmon32=cmmon32.exe
alias cmstp=cmstp.exe
alias cofire=cofire.exe
alias colorcpl=colorcpl.exe
alias comp=comp.exe
alias compact=compact.exe
alias CompatTelRunner=CompatTelRunner.exe
alias CompMgmtLauncher=CompMgmtLauncher.exe
alias CompPkgSrv=CompPkgSrv.exe
alias ComputerDefaults=ComputerDefaults.exe
alias conhost=conhost.exe
alias consent=consent.exe
alias control=control.exe
alias convert=convert.exe
alias convertvhd=convertvhd.exe
alias coredpussvr=coredpussvr.exe
alias CredentialEnrollmentManager=CredentialEnrollmentManager.exe
alias CredentialUIBroker=CredentialUIBroker.exe
alias credwiz=credwiz.exe
alias cscript=cscript.exe
alias csrss=csrss.exe
alias ctfmon=ctfmon.exe
alias cttune=cttune.exe
alias cttunesvr=cttunesvr.exe
alias curl=curl.exe
alias CustomInstallExec=CustomInstallExec.exe
alias d3dconfig=d3dconfig.exe
alias dasHost=dasHost.exe
alias DataExchangeHost=DataExchangeHost.exe
alias DataStoreCacheDumpTool=DataStoreCacheDumpTool.exe
alias dccw=dccw.exe
alias dcomcnfg=dcomcnfg.exe
alias ddodiag=ddodiag.exe
alias Defrag=Defrag.exe
alias deploymentcsphelper=deploymentcsphelper.exe
alias desktopimgdownldr=desktopimgdownldr.exe
alias DeviceCensus=DeviceCensus.exe
alias DeviceCredentialDeployment=DeviceCredentialDeployment.exe
alias DeviceEject=DeviceEject.exe
alias DeviceEnroller=DeviceEnroller.exe
alias DevicePairingWizard=DevicePairingWizard.exe
alias DeviceProperties=DeviceProperties.exe
alias DFDWiz=DFDWiz.exe
alias dfrgui=dfrgui.exe
alias dgtrayicon=dgtrayicon.exe
alias dialer=dialer.exe
alias directxdatabaseupdater=directxdatabaseupdater.exe
alias diskpart=diskpart.exe
alias diskperf=diskperf.exe
alias diskraid=diskraid.exe
alias DiskSnapshot=DiskSnapshot.exe
alias diskusage=diskusage.exe
alias Dism=Dism.exe
alias dispdiag=dispdiag.exe
alias DisplaySwitch=DisplaySwitch.exe
alias djoin=djoin.exe
alias dllhost=dllhost.exe
alias dllhst3g=dllhst3g.exe
alias dmcertinst=dmcertinst.exe
alias dmcfghost=dmcfghost.exe
alias dmclient=dmclient.exe
alias DmNotificationBroker=DmNotificationBroker.exe
alias DmOmaCpMo=DmOmaCpMo.exe
alias dnscacheugc=dnscacheugc.exe
alias doskey=doskey.exe
alias dpapimig=dpapimig.exe
alias DpiScaling=DpiScaling.exe
alias dpnsvr=dpnsvr.exe
alias driverquery=driverquery.exe
alias drvinst=drvinst.exe
alias DsmUserTask=DsmUserTask.exe
alias dsregcmd=dsregcmd.exe
alias dstokenclean=dstokenclean.exe
alias dtdump=dtdump.exe
alias dusmtask=dusmtask.exe
alias dvdplay=dvdplay.exe
alias dwm=dwm.exe
alias DXCap=DXCap.exe
alias DXCpl=DXCpl.exe
alias dxdiag=dxdiag.exe
alias dxgiadaptercache=dxgiadaptercache.exe
alias Dxpserver=Dxpserver.exe
alias Eap3Host=Eap3Host.exe
alias EaseOfAccessDialog=EaseOfAccessDialog.exe
alias easinvoker=easinvoker.exe
alias EASPolicyManagerBrokerHost=EASPolicyManagerBrokerHost.exe
alias EDPCleanup=EDPCleanup.exe
alias edpnotify=edpnotify.exe
alias EduPrintProv=EduPrintProv.exe
alias EEURestart=EEURestart.exe
alias efsui=efsui.exe
alias EhStorAuthn=EhStorAuthn.exe
alias EoAExperiences=EoAExperiences.exe
alias esentutl=esentutl.exe
alias esimtool=esimtool.exe
alias eudcedit=eudcedit.exe
alias eventcreate=eventcreate.exe
alias eventvwr=eventvwr.exe
alias expand=expand.exe
alias extrac32=extrac32.exe
alias fc=fc.exe
alias fhmanagew=fhmanagew.exe
alias FileDialogBroker=FileDialogBroker.exe
alias FileHistory=FileHistory.exe
alias find=find.exe
alias findstr=findstr.exe
alias finger=finger.exe
alias fixmapi=fixmapi.exe
alias fltMC=fltMC.exe
alias FMAPP=FMAPP.exe
alias FMService64=FMService64.exe
alias fodhelper=fodhelper.exe
alias Fondue=Fondue.exe
alias fontdrvhost=fontdrvhost.exe
alias fontview=fontview.exe
alias forfiles=forfiles.exe
alias fsavailux=fsavailux.exe
alias FsIso=FsIso.exe
alias fsquirt=fsquirt.exe
alias fsutil=fsutil.exe
alias ftp=ftp.exe
alias fvenotify=fvenotify.exe
alias FXSCOVER=FXSCOVER.exe
alias FXSSVC=FXSSVC.exe
alias FXSUNATD=FXSUNATD.exe
alias GameBarPresenceWriter=GameBarPresenceWriter.exe
alias GamePanel=GamePanel.exe
alias GenValObj=GenValObj.exe
alias getmac=getmac.exe
alias gpresult=gpresult.exe
alias gpupdate=gpupdate.exe
alias grpconv=grpconv.exe
alias hcsdiag=hcsdiag.exe
alias hdwwiz=hdwwiz.exe
alias help=help.exe
alias hnsdiag=hnsdiag.exe
alias hvax64=hvax64.exe
alias hvix64=hvix64.exe
alias icacls=icacls.exe
alias IcsEntitlementHost=IcsEntitlementHost.exe
alias icsunattend=icsunattend.exe
alias ie4uinit=ie4uinit.exe
alias ie4ushowIE=ie4ushowIE.exe
alias IESettingSync=IESettingSync.exe
alias ieUnatt=ieUnatt.exe
alias iexpress=iexpress.exe
alias ImController=ImController.InfInstaller.exe
alias immersivetpmvscmgrsvr=immersivetpmvscmgrsvr.exe
alias InfDefaultInstall=InfDefaultInstall.exe
alias InputSwitchToastHandler=InputSwitchToastHandler.exe
alias ipconfig=ipconfig.exe
alias iscsicli=iscsicli.exe
alias iscsicpl=iscsicpl.exe
alias ISM=ISM.exe
alias isoburn=isoburn.exe
alias klist=klist.exe
alias ksetup=ksetup.exe
alias ktmutil=ktmutil.exe
alias la57setup=la57setup.exe
alias label=label.exe
alias LanguageComponentsInstallerComHandler=LanguageComponentsInstallerComHandler.exe
alias LaunchTM=LaunchTM.exe
alias LaunchWinApp=LaunchWinApp.exe
alias LegacyNetUXHost=LegacyNetUXHost.exe
alias LicenseManagerShellext=LicenseManagerShellext.exe
alias licensingdiag=licensingdiag.exe
alias LicensingUI=LicensingUI.exe
alias LiveCaptions=LiveCaptions.exe
alias LNBITSSvc=LNBITSSvc.exe
alias LocationNotificationWindows=LocationNotificationWindows.exe
alias Locator=Locator.exe
alias LockAppHost=LockAppHost.exe
alias LockScreenContentServer=LockScreenContentServer.exe
alias lodctr=lodctr.exe
alias logagent=logagent.exe
alias logman=logman.exe
alias LogonUI=LogonUI.exe
alias lpkinstall=lpkinstall.exe
alias lpksetup=lpksetup.exe
alias lpremove=lpremove.exe
alias LsaIso=LsaIso.exe
alias lsass=lsass.exe
alias Magnify=Magnify.exe
alias makecab=makecab.exe
alias manage-bde=manage-bde.exe
alias mblctr=mblctr.exe
alias mcbuilder=mcbuilder.exe
alias MDEServer=MDEServer.exe
alias MDMAgent=MDMAgent.exe
alias MDMAppInstaller=MDMAppInstaller.exe
alias MdmDiagnosticsTool=MdmDiagnosticsTool.exe
alias MdRes=MdRes.exe
alias MdSched=MdSched.exe
alias mfpmp=mfpmp.exe
alias MicrosoftEdgeBCHost=MicrosoftEdgeBCHost.exe
alias MicrosoftEdgeCP=MicrosoftEdgeCP.exe
alias MicrosoftEdgeDevTools=MicrosoftEdgeDevTools.exe
alias MicrosoftEdgeSH=MicrosoftEdgeSH.exe
alias mmc=mmc.exe
alias mmc=mmc.exe.config
alias mmgaserver=mmgaserver.exe
alias mobsync=mobsync.exe
alias MoNotificationUxStub=MoNotificationUxStub.exe
alias mountvol=mountvol.exe
alias mpnotify=mpnotify.exe
alias MpSigStub=MpSigStub.exe
alias MRT=MRT.exe
alias MSchedExe=MSchedExe.exe
alias msconfig=msconfig.exe
alias msdt=msdt.exe
alias msdtc=msdtc.exe
alias msfeedssync=msfeedssync.exe
alias mshta=mshta.exe
alias msiexec=msiexec.exe
alias msinfo32=msinfo32.exe
alias msra=msra.exe
alias MsSpellCheckingHost=MsSpellCheckingHost.exe
alias mstsc=mstsc.exe
alias mtstocom=mtstocom.exe
alias MuiUnattend=MuiUnattend.exe
alias MultiDigiMon=MultiDigiMon.exe
alias Narrator=Narrator.exe
alias nbtstat=nbtstat.exe
alias ndadmin=ndadmin.exe
alias NDKPerfCmd=NDKPerfCmd.exe
alias NDKPing=NDKPing.exe
alias net=net.exe
alias net1=net1.exe
alias netbtugc=netbtugc.exe
alias netcfg=netcfg.exe
alias NetCfgNotifyObjectHost=NetCfgNotifyObjectHost.exe
alias NetEvtFwdr=NetEvtFwdr.exe
alias NetHost=NetHost.exe
alias netiougc=netiougc.exe
alias Netplwiz=Netplwiz.exe
alias netsh=netsh.exe
alias newdev=newdev.exe
alias NgcIso=NgcIso.exe
alias nltest=nltest.exe
alias nmbind=nmbind.exe
alias nmscrub=nmscrub.exe
alias notepad=notepad.exe
alias nslookup=nslookup.exe
alias ntoskrnl=ntoskrnl.exe
alias ntprint=ntprint.exe
alias nvspinfo=nvspinfo.exe
alias odbcad32=odbcad32.exe
alias odbcconf=odbcconf.exe
alias ofdeploy=ofdeploy.exe
alias omadmclient=omadmclient.exe
alias omadmprc=omadmprc.exe
alias OneDriveSetup=OneDriveSetup.exe
alias OOBE-Maintenance=OOBE-Maintenance.exe
alias openfiles=openfiles.exe
alias OpenWith=OpenWith.exe
alias OptionalFeatures=OptionalFeatures.exe
alias osk=osk.exe
alias pacjsworker=pacjsworker.exe
alias PackagedCWALauncher=PackagedCWALauncher.exe
alias PasswordOnWakeSettingFlyout=PasswordOnWakeSettingFlyout.exe
alias pcalua=pcalua.exe
alias pcaui=pcaui.exe
alias pcwrun=pcwrun.exe
alias perfmon=perfmon.exe
alias phoneactivate=phoneactivate.exe
alias PickerHost=PickerHost.exe
alias PinEnrollmentBroker=PinEnrollmentBroker.exe
alias PkgMgr=PkgMgr.exe
alias PktMon=PktMon.exe
alias plasrv=plasrv.exe
alias PnPUnattend=PnPUnattend.exe
alias pnputil=pnputil.exe
alias poqexec=poqexec.exe
alias pospaymentsworker=pospaymentsworker.exe
alias powercfg=powercfg.exe
alias PresentationHost=PresentationHost.exe
alias prevhost=prevhost.exe
alias print=print.exe
alias printfilterpipelinesvc=printfilterpipelinesvc.exe
alias PrintIsolationHost=PrintIsolationHost.exe
alias printui=printui.exe
alias proquota=proquota.exe
alias provlaunch=provlaunch.exe
alias provtool=provtool.exe
alias ProximityUxHost=ProximityUxHost.exe
alias prproc=prproc.exe
alias psr=psr.exe
alias pwlauncher=pwlauncher.exe
alias rasautou=rasautou.exe
alias rasdial=rasdial.exe
alias raserver=raserver.exe
alias rasphone=rasphone.exe
alias rdpclip=rdpclip.exe
alias rdpinput=rdpinput.exe
alias RdpSa=RdpSa.exe
alias RdpSaProxy=RdpSaProxy.exe
alias RdpSaUacHelper=RdpSaUacHelper.exe
alias rdrleakdiag=rdrleakdiag.exe
alias ReAgentc=ReAgentc.exe
alias recdisc=recdisc.exe
alias recover=recover.exe
alias RecoveryDrive=RecoveryDrive.exe
alias refsutil=refsutil.exe
alias reg=reg.exe
alias regedt32=regedt32.exe
alias regini=regini.exe
alias Register-CimProvider=Register-CimProvider.exe
alias regsvr32=regsvr32.exe
alias rekeywiz=rekeywiz.exe
alias relog=relog.exe
alias RelPost=RelPost.exe
alias RemotePosWorker=RemotePosWorker.exe
alias repair-bde=repair-bde.exe
alias replace=replace.exe
alias ResetEngine=ResetEngine.exe
alias resmon=resmon.exe
alias RMActivate=RMActivate.exe
alias RMActivate_isv=RMActivate_isv.exe
alias RMActivate_ssp=RMActivate_ssp.exe
alias RMActivate_ssp_isv=RMActivate_ssp_isv.exe
alias RmClient=RmClient.exe
alias rmttpmvscmgrsvr=rmttpmvscmgrsvr.exe
alias Robocopy=Robocopy.exe
alias RpcPing=RpcPing.exe
alias rrinstaller=rrinstaller.exe
alias rstrui=rstrui.exe
alias RtkAudUService64=RtkAudUService64.exe
alias runas=runas.exe
alias rundll32=rundll32.exe
alias runexehelper=runexehelper.exe
alias RunLegacyCPLElevated=RunLegacyCPLElevated.exe
alias runonce=runonce.exe
alias RuntimeBroker=RuntimeBroker.exe
alias sc=sc.exe
alias schtasks=schtasks.exe
alias sdbinst=sdbinst.exe
alias sdchange=sdchange.exe
alias sdclt=sdclt.exe
alias sdiagnhost=sdiagnhost.exe
alias SearchFilterHost=SearchFilterHost.exe
alias SearchIndexer=SearchIndexer.exe
alias SearchProtocolHost=SearchProtocolHost.exe
alias SecEdit=SecEdit.exe
alias secinit=secinit.exe
alias SecureBootEncodeUEFI=SecureBootEncodeUEFI.exe
alias securekernel=securekernel.exe
alias SecurityHealthHost=SecurityHealthHost.exe
alias SecurityHealthService=SecurityHealthService.exe
alias SecurityHealthSystray=SecurityHealthSystray.exe
alias SensorDataService=SensorDataService.exe
alias services=services.exe
alias sessionmsg=sessionmsg.exe
alias sethc=sethc.exe
alias setspn=setspn.exe
alias setupcl=setupcl.exe
alias setupugc=setupugc.exe
alias setx=setx.exe
alias sfc=sfc.exe
alias ShellAppRuntime=ShellAppRuntime.exe
alias shrpubw=shrpubw.exe
alias shutdown=shutdown.exe
alias sigverif=sigverif.exe
alias SIHClient=SIHClient.exe
alias sihost=sihost.exe
alias SlideToShutDown=SlideToShutDown.exe
alias slui=slui.exe
alias smartscreen=smartscreen.exe
alias smss=smss.exe
alias SndVol=SndVol.exe
alias snmptrap=snmptrap.exe
alias sort=sort.exe
alias SpaceAgent=SpaceAgent.exe
alias spaceman=spaceman.exe
alias spaceutil=spaceutil.exe
alias SpatialAudioLicenseSrv=SpatialAudioLicenseSrv.exe
alias Spectrum=Spectrum.exe
alias spoolsv=spoolsv.exe
alias sppsvc=sppsvc.exe
alias srdelayed=srdelayed.exe
alias SrTasks=SrTasks.exe
alias stordiag=stordiag.exe
alias subst=subst.exe
alias svchost=svchost.exe
alias sxstrace=sxstrace.exe
alias SyncHost=SyncHost.exe
alias SysResetErr=SysResetErr.exe
alias systeminfo=systeminfo.exe
alias SystemPropertiesAdvanced=SystemPropertiesAdvanced.exe
alias SystemPropertiesComputerName=SystemPropertiesComputerName.exe
alias SystemPropertiesDataExecutionPrevention=SystemPropertiesDataExecutionPrevention.exe
alias SystemPropertiesHardware=SystemPropertiesHardware.exe
alias SystemPropertiesPerformance=SystemPropertiesPerformance.exe
alias SystemPropertiesProtection=SystemPropertiesProtection.exe
alias SystemPropertiesRemote=SystemPropertiesRemote.exe
alias systemreset=systemreset.exe
alias SystemSettingsAdminFlows=SystemSettingsAdminFlows.exe
alias SystemSettingsBroker=SystemSettingsBroker.exe
alias SystemSettingsRemoveDevice=SystemSettingsRemoveDevice.exe
alias SystemUWPLauncher=SystemUWPLauncher.exe
alias systray=systray.exe
alias tabcal=tabcal.exe
alias takeown=takeown.exe
alias TapiUnattend=TapiUnattend.exe
alias tar=tar.exe
alias taskhostw=taskhostw.exe
alias taskkill=taskkill.exe
alias tasklist=tasklist.exe
alias Taskmgr=Taskmgr.exe
alias tcblaunch=tcblaunch.exe
alias tcmsetup=tcmsetup.exe
alias ThumbnailExtractionHost=ThumbnailExtractionHost.exe
alias TieringEngineService=TieringEngineService.exe
alias timeout=timeout.exe
alias TokenBrokerCookies=TokenBrokerCookies.exe
alias TpmInit=TpmInit.exe
alias TpmTool=TpmTool.exe
alias tpmvscmgr=tpmvscmgr.exe
alias tpmvscmgrsvr=tpmvscmgrsvr.exe
alias tracerpt=tracerpt.exe
alias TSTheme=TSTheme.exe
alias TSWbPrxy=TSWbPrxy.exe
alias TsWpfWrp=TsWpfWrp.exe
alias ttdinject=ttdinject.exe
alias tttracer=tttracer.exe
alias typeperf=typeperf.exe
alias tzsync=tzsync.exe
alias tzutil=tzutil.exe
alias ucsvc=ucsvc.exe
alias UIMgrBroker=UIMgrBroker.exe
alias unlodctr=unlodctr.exe
alias unregmp2=unregmp2.exe
alias upfc=upfc.exe
alias UpgradeResultsUI=UpgradeResultsUI.exe
alias upnpcont=upnpcont.exe
alias UPPrinterInstaller=UPPrinterInstaller.exe
alias UserAccountBroker=UserAccountBroker.exe
alias UserAccountControlSettings=UserAccountControlSettings.exe
alias UserDataSource=UserDataSource.exe
alias userinit=userinit.exe
alias UsoClient=UsoClient.exe
alias UtcDecoderHost=UtcDecoderHost.exe
alias Utilman=Utilman.exe
alias VaultCmd=VaultCmd.exe
alias vds=vds.exe
alias vdsldr=vdsldr.exe
alias verclsid=verclsid.exe
alias verifier=verifier.exe
alias verifiergui=verifiergui.exe
alias vfpctrl=vfpctrl.exe
alias vmcompute=vmcompute.exe
alias vmwp=vmwp.exe
alias VoiceAccess=VoiceAccess.exe
alias VsGraphicsDesktopEngine=VsGraphicsDesktopEngine.exe
alias VsGraphicsRemoteEngine=VsGraphicsRemoteEngine.exe
alias vssadmin=vssadmin.exe
alias VSSVC=VSSVC.exe
alias vulkaninfo-1-999-0-0-0=vulkaninfo-1-999-0-0-0.exe
alias vulkaninfo=vulkaninfo.exe
alias w32tm=w32tm.exe
alias waitfor=waitfor.exe
alias WallpaperHost=WallpaperHost.exe
alias wbadmin=wbadmin.exe
alias wbengine=wbengine.exe
alias wecutil=wecutil.exe
alias WerFault=WerFault.exe
alias WerFaultSecure=WerFaultSecure.exe
alias wermgr=wermgr.exe
alias wevtutil=wevtutil.exe
alias wextract=wextract.exe
alias WFS=WFS.exe
alias where=where.exe
alias whoami=whoami.exe
alias wiaacmgr=wiaacmgr.exe
alias wiawow64=wiawow64.exe
alias wifitask=wifitask.exe
alias wimserv=wimserv.exe
alias WinBioDataModelOOBE=WinBioDataModelOOBE.exe
alias Windows=Windows.Media.BackgroundPlayback.exe
alias Windows=Windows.WARP.JITService.exe
alias WindowsActionDialog=WindowsActionDialog.exe
alias WindowsUpdateElevatedInstaller=WindowsUpdateElevatedInstaller.exe
alias wininit=wininit.exe
alias winload=winload.exe
alias winlogon=winlogon.exe
alias winresume=winresume.exe
alias winrs=winrs.exe
alias winrshost=winrshost.exe
alias WinRTNetMUAHostServer=WinRTNetMUAHostServer.exe
alias WinSAT=WinSAT.exe
alias winver=winver.exe
alias wkspbroker=wkspbroker.exe
alias wksprt=wksprt.exe
alias wlanext=wlanext.exe
alias wlrmdr=wlrmdr.exe
alias WMPDMC=WMPDMC.exe
alias WorkFolders=WorkFolders.exe
alias wowreg32=wowreg32.exe
alias WpcMon=WpcMon.exe
alias WpcTok=WpcTok.exe
alias WPDShextAutoplay=WPDShextAutoplay.exe
alias wpnpinst=wpnpinst.exe
alias wpr=wpr.exe
alias write=write.exe
alias wscadminui=wscadminui.exe
alias WSCollect=WSCollect.exe
alias wscript=wscript.exe
alias wsl=wsl.exe
alias wslg=wslg.exe
alias WSManHTTPConfig=WSManHTTPConfig.exe
alias wsmprovhost=wsmprovhost.exe
alias wsqmcons=wsqmcons.exe
alias WSReset=WSReset.exe
alias wuapihost=wuapihost.exe
alias wuauclt=wuauclt.exe
alias WUDFCompanionHost=WUDFCompanionHost.exe
alias WUDFHost=WUDFHost.exe
alias wusa=wusa.exe
alias WWAHost=WWAHost.exe
alias XblGameSaveTask=XblGameSaveTask.exe
alias xcopy=xcopy.exe
alias xwizard=xwizard.exe
alias bfsvc=bfsvc.exe
alias explorer=explorer.exe
alias HelpPane=HelpPane.exe
alias hh=hh.exe
alias notepad=notepad.exe
alias regedit=regedit.exe
alias splwow64=splwow64.exe
alias winhlp32=winhlp32.exe
alias write=write.exe
alias mofcomp=mofcomp.exe
alias scrcons=scrcons.exe
alias unsecapp=unsecapp.exe
alias wbemtest=wbemtest.exe
alias WinMgmt=WinMgmt.exe
alias WMIADAP=WMIADAP.exe
alias WmiApSrv=WmiApSrv.exe
alias WMIC=WMIC.exe
alias WmiPrvSE=WmiPrvSE.exe
alias powershell=powershell.exe
alias powershell=powershell.exe.config
alias powershell_ise=powershell_ise.exe
alias powershell_ise=powershell_ise.exe.config
alias scp=scp.exe
alias sftp=sftp.exe
alias ssh-add=ssh-add.exe
alias ssh-agent=ssh-agent.exe
alias ssh-keygen=ssh-keygen.exe
alias ssh-keyscan=ssh-keyscan.exe
alias ssh=ssh.exe
alias bash=bash.exe
alias clipchamp=clipchamp.exe
alias GameBarElevatedFT_Alias=GameBarElevatedFT_Alias.exe
alias lenovoutility=lenovoutility.exe
alias MediaPlayer=MediaPlayer.exe
alias MicrosoftEdge=MicrosoftEdge.exe
alias MicrosoftWindows=MicrosoftWindows.DesktopStickerEditorCentennial.exe
alias mspaint=mspaint.exe
alias msrdc=msrdc.exe
alias msteams=msteams.exe
alias msteamsupdate=msteamsupdate.exe
alias notepad=notepad.exe
alias PAD=PAD.BrowserNativeMessageHost.exe
alias pbrush=pbrush.exe
alias python=python.exe
alias python3=python3.exe
alias Skype=Skype.exe
alias SnippingTool=SnippingTool.exe
alias ttb=ttb.exe
alias ubuntu=ubuntu.exe
alias WindowsPackageManagerServer=WindowsPackageManagerServer.exe
alias winget=winget.exe
alias wsl=wsl.exe
alias wslconfig=wslconfig.exe
alias wslg=wslg.exe
alias wt=wt.exe
alias XboxPcApp=XboxPcApp.exe
alias code-tunnel=code-tunnel.exe
